11111111111110011111
11111111111000011111
11111111110000011111
11111111100000011111
11111110000000011111
11111110000000011111
11111110000000011111
11111111000001111111
11111111110011111111
11111111111111111111
11111111111111111111
11111111111111111111
11111111111111111111
11111111111111111111
11111111111111111111