11111111111111111111
11111111111111111111
11111111111111111111
11111111111111111111
11111111111111111111
11111111111111111111
11111111111111111111
11111000111111111111
11111110001000111111
11111111100001111111
11111111111000011111
11111111111111111111
11111111111111111111
11111111111111111111